$$$$$$$$$$$$$$$$$$$$$$$$$
$.......................$
$..&........&........&..$
$..#..#...#...#...#..#..$
$..#..#...#$$$#...#..#..$
$..#..#...#...#...#..#..$
$..#..#...#...#...#..#..$
$..#..#...#...#...#..#..$
$..#..#...#...#...#..#..$
$..#..#...#...#...#..#..$
$..#..#...#...#...#..#..$
$..#..#...........#..#..$
$.......................$
$$........#...#........$$
$...###...........###...$
$.......................$
$.........#####.........$
$.#..#....#...#....#..#.$
$.#..#....#...#....#..#.$
$.#..#....#...#....#..#.$
$.#..#.............#..#.$
$.#..#......@......#..#.$
$..........###..........$
$..........#!#..........$
$$$$$$$$$$$$$$$$$$$$$$$$$