$$$$$$$$$$$$$$$$$$$$$$$$$
$...#...#...#...#...#...$
$...#...#...#...#...#...$
$.&.#.&.#.&.#.&.#.&.#.&.$
$...#...#...#...#...#...$
$...#...#...#...#...#...$
$...$...$...$...$...$...$
$.......................$
$.......................$
$........#.....#........$
$#....#..#.....#..#....#$
$#....####.....####....#$
$$....$..#..#..#..$....$$
$........$..$..$........$
$........#.....#........$
$........#.....#........$
$.......................$
$.......................$
$###.###.#.....#.###.###$
$...#...#.......#...#...$
$...#...#.......#...#...$
$...#...#...@...#...#...$
$...#...#..###..#...#...$
$..........#!#..........$
$$$$$$$$$$$$$$$$$$$$$$$$$