$$$$$$$$$$$$$$$$$$$$$$$$$
$.......................$
$.......................$
$...&.......&.......&...$
$.......................$
$.$$$..$..$$$.$$$.$..$$.$
$.$.$.$.$..$...$..$..$..$
$.$$..$$$..$...$..$..$$.$
$.$.$.$.$..$...$..$..$..$
$.$$$.$.$..$...$..$$.$$.$
$.......................$
$.......................$
$...$$..$...$$$..$...$..$
$..$....$....$...$...$..$
$..$....$....$....$$$...$
$..$....$....$.....$....$
$...$$..$....$.....$....$
$.......................$
$.......................$
$.......................$
$.......................$
$...........@...........$
$..........###..........$
$..........#!#..........$
$$$$$$$$$$$$$$$$$$$$$$$$$